[level]
tileset = Images\dw1tileset.png
map =    1, 1, 1, 1, 1, 1, 1,26,26,26,26,26,26,26,26, 1, 1, 1, 1, 1, 1, 1,26, 1, 1, 1,26,27,26,26
         1, 3, 3, 3, 3, 3, 1,26,27,26,27,27,26,27,26, 1, 3, 3, 3, 3, 3, 1,26, 1, 3, 1,26,26,26,26
         1, 3, 3, 1, 3, 3, 1, 1, 1, 1, 3, 3, 1, 1, 1, 1, 3, 3, 1, 3, 3, 1,26,26,26,27,27,26,26,26
         1, 3, 3, 3, 3, 3, 3, 3, 3, 3, 3, 3, 3, 3, 3, 3, 3, 3, 3, 3, 3, 1,26,27,27,27,26,26,26,26
         1, 3, 3, 3, 3, 3, 1, 1, 1, 1, 1, 1, 1, 1, 1, 1, 3, 3, 3, 3, 3, 1,26,26,26,26,26,26,26,26
         1, 1, 1, 1, 1, 3, 1, 3, 3, 3, 3, 3, 3, 3, 3, 1, 1, 1, 3, 1, 1, 1, 1, 1, 3, 1, 1, 1,26,26
         1, 3, 3, 3, 1, 3, 1, 3, 3, 3, 3, 3, 3, 1, 3, 1, 3, 3, 3, 3, 3, 3, 3, 3, 3, 3, 3, 1,26,26
         1, 3, 3, 3, 3, 3, 1, 3, 3, 3, 3, 3, 3, 3, 3, 1, 3, 3, 3, 3, 3, 3, 3, 3, 3, 3, 3, 1,26,26
[1]
name = wall
wall = true
block = true

[3]
name = floor